Cans & Nodozes
49 49
default.table
Milo van Handel
BASE
XXXXXXXXXXXXXXXXXXXXXXXXXXXXXXXXXXXXXXXXXXXXXXXXX
X,......................,......................,X
X.,.....................,.....................,.X
X..,....................,....................,..X
X...,...................,...................,...X
X....,..................,..................,....X
X.....,.................,.................,.....X
X......,................,................,......X
X.......,...............,...............,.......X
X........,..............,..............,........X
X.........,.............,.............,.........X
X..........,............,............,..........X
X...........,...........,...........,...........X
X............,..........,..........,............X
X.............,.........,.........,.............X
X..............,........,........,..............X
X...............,.......,.......,...............X
X................,......,......,................X
X.................,.....,.....,.................X
X..................,....,....,..................X
X...................,...,...,...................X
X....................,..,..,....................X
X.....................,.,.,.....................X
X......................,,,......................X
X,,,,,,,,,,,,,,,,,,,,,,,,,,,,,,,,,,,,,,,,,,,,,,,X
X......................,,,......................X
X.....................,.,.,.....................X
X....................,..,..,....................X
X...................,...,...,...................X
X..................,....,....,..................X
X.................,.....,.....,.................X
X................,......,......,................X
X...............,.......,.......,...............X
X..............,........,........,..............X
X.............,.........,.........,.............X
X............,..........,..........,............X
X...........,...........,...........,...........X
X..........,............,............,..........X
X.........,.............,.............,.........X
X........,..............,..............,........X
X.......,...............,...............,.......X
X......,................,................,......X
X.....,.................,.................,.....X
X....,..................,..................,....X
X...,...................,...................,...X
X..,....................,....................,..X
X.,.....................,.....................,.X
X,......................,......................,X
XXXXXXXXXXXXXXXXXXXXXXXXXXXXXXXXXXXXXXXXXXXXXXXXX
OBJECT
-------------------------------------------------
-                                               -
-                                               -
-                                               -
-                                               -
-                                               -
-                                               -
-                                               -
-                                               -
-                                               -
-                                               -
-                                               -
-                                               -
-                                               -
-                                               -
-                                               -
-                                               -
-                                               -
-                                               -
-                                               -
-                                               -
-                                               -
-                                               -
-                                               -
-                                               -
-                                               -
-                                               -
-                                               -
-                                               -
-                                               -
-                                               -
-                                               -
-                                               -
-                                               -
-                                               -
-                                               -
-                                               -
-                                               -
-                                               -
-                                               -
-                                               -
-                                               -
-                                               -
-                                               -
-                                               -
-                                               -
-                                               -
-                                               -
-------------------------------------------------
TOPLEVEL
-------------------------------------------------
-                                               -
-                                               -
-                                               -
-                                               -
-                                               -
-                                               -
-                                               -
-                                               -
-                                               -
-                                               -
-                                               -
-                                               -
-                                               -
-                                               -
-                                               -
-                                               -
-                                               -
-                                               -
-                                               -
-                                               -
-                                               -
-                                               -
-                                               -
-                                               -
-                                               -
-                                               -
-                                               -
-                                               -
-                                               -
-                                               -
-                                               -
-                                               -
-                                               -
-                                               -
-                                               -
-                                               -
-                                               -
-                                               -
-                                               -
-                                               -
-                                               -
-                                               -
-                                               -
-                                               -
-                                               -
-                                               -
-                                               -
-------------------------------------------------
EVENT
TELEPORT T 0 1 100 100 90 100
TELEPORT T 1 1 100 100 90 100
TELEPORT T 2 1 100 100 90 100
ENTITY
ROCKET_SMALL 2064 1480 0 200
SPAWN  2064   64   96  0
%SPAWN  3008 64   160 0
%SPAWN  64   3008 32  0
%SPAWN  3008 3008 224 0
TROLL  1536 1536 0   0
BADCAN 1536 64   0   0
BADCAN 3008 1536 0   0
BADCAN 1536 3008 0   0
BADCAN 64   1536 0   0
BADCAN    1152 768  0   0
BADCAN    1920 768  0   0
BADCAN    1152 2304 0   0
BADCAN    1920 2304 0   0
BADCAN    768  1152 0   0
BADCAN    768  1920 0   0
BADCAN    2304 1152 0   0
BADCAN    2304 1920 0   0
BULLETS 128 128 0 0
BULLETS 192 128 0 0
BULLETS 256 128 0 0
BULLETS 320 128 0 0
BULLETS 384 128 0 0
#Row of weapons.
CHAINGUN 128 192 0 0
SHOTGUN 192 192 0 0
RAILGUN 256 192 0 0
BAZOOKA 320 192 0 0
EGUN 384 192 0 0
SNIPER 448 192 0 0
