AI Test
25 25
default.table
Milo van Handel
OBJECTIVE
type ELIMINATE_CLASS
class BADDIE
nextmap home.map
BASE
XXXXXXXXXXXXXXXXXXXXXXXXX
X.......X.......X.......X
X.......X...,...X.......X
X.......X..,,,..X.......X
X.......X.,.,.,.X.......X
X.......X,..,..,X.......X
X.......,...,...,.......X
X......,BBBB,BBBB,......X
XXXXXX,BB...,...BB,XXXXXX
X....,.B....,....B.,....X
X...,..B....,....B..,...X
X..,...B....,....B...,..X
X.,,,,,,,,,,,,,,,,,,,,,.X
X..,...B....,....B...,..X
X...,..B....,....B..,...X
X....,.B....,....B.,....X
XXXXXX,BB...,...BB,XXXXXX
X......,BBBB,BBBB,......X
X.......,...,...,.......X
X.......X,..,..,X.......X
X.......X.,.,.,.X.......X
X.......X..,,,..X.......X
X.......X...,...X.......X
X.......X.......X.......X
XXXXXXXXXXXXXXXXXXXXXXXXX
OBJECT
-------------------------
-       -       -       -
-       -       -       -
-       -       -       -
-       -       -       -
-       -       -       -
-                       -
-       ---- ----       -
------ -         - ------
-      -         -      -
-      -         -      -
-      -         -      -
-                       -
-      -         -      -
-      -         -      -
-      -         -      -
------ -         - ------
-       ---- ----       -
-                       -
-       -       -       -
-       -       -       -
-       -       -       -
-       -       -       -
-       -       -       -
-------------------------
ENTITY
SPAWN 768 64 128 0
%SPAWN 64 768 64 0
%SPAWN 1472 768 192 0
%SPAWN 768 1472 0 0
CHAINGUN 768 134 0 0
RAILGUN 128 774 0 0
SHOTGUN 1408 774 0 0
EGUN 768 1414 0 0
CHAINSAW 768 300 0 0

SHELLS 64 56 0 0
SHELLS 128 56 0 0
CELLS 1472 56 0 0
CELLS 1408 56 0 0
BULLETS 64 1472 0 0
BULLETS 128 1472 0 0
SLUGS 1472 1472 0 0
SLUGS 1408 1472 0 0

CAN 576 576 0 0
CAN 576 960 0 0
#CARROT 960 576 0 0
CAN 960 576 0 0
CAN 960 960 0 0

BAZOOKA 768 768 0 0
BORG 768 1408 0 0
TROLL 128 768 64 0
FLAMER 1408 768 192 0
ZOMBIE 448 1088 32 0
COBOL 448 448 96 0
GATES 1088 448 160 0
MSCP 1088 1088 224 0
GOWN 768 768 128 0
