# desktop.map  "GUI Wars"
# Designed for Gnome vs KDE
The Battle for the desktop.
77 65
desktop.table
James Andrews
BASE
"""""""""""""""""""""""""""""""""""""""""""""""""""""""""""""""""""""""""""""
"tyyyyyyyyyyyyyyyyyyyyyyyyyyyyyyyyyyyu"tyyyyyyyyyyyyyyyyyyyyyyyyyyyyyyyyyyyu"
"g,,,,,,,,,,,,,,,,,,,,,,,,,,,,,,,,,,,j"g,,,,,,,,,,,,,,,,,,,,,,,,,,,,,,,,,,,j"
"g,,,,,,,,,,,,,,,,,,,,,,,,,,,,,,,,,,,j"g,,,,,,,,,,,,,,,,,,,,,,,,,,,,,,,,,,,j"
"g,,,,,,,,,,,,,,,,,,,,,,,,,,,,,,,,,,,j"g,,,,,,,,,,,,,,,,,,,,,,,,,,,,,,,,,,,j"
"g,,,,nnnnnnnnnnnnnnnnnnnnnnnnnnn,,,,j"g,,,,nnnnnnnnnnnnnnnnnnnnnnnnnnn,,,,j"
"g,,,jQWQWQWQWQWQWQWQWQWQWQWQWQWQg,,,j"g,,,j;;;;;;;;;;;;;;;;;;;;;;;;;;;g,,,j"
"g,,,jASASA78888889SASASASASACOSAg,,,j"g,,,j;;;7888889;;;;;;;;;;;;;OC;;g,,,j"
"g,,,jQWQWQ::::::::WQWQWQWQWQOOWQg,,,j"g,,,j;;;,,,,,,,;er;;;;;;;;;;OO;;g,,,j"
"g,,,jASASA::::::::SASASASASASASAg,,,j"g,,,j;;;,,,,,,,;df;;;;;;;;;;;;;;g,,,j"
"g,,,jQWQWQ:::::788889QWQWQWQWQWQg,,,j"g,,,j;;;,,,,,,,;dfer;;er;;;;;;;;g,,,j"
"g,,,jASASA:::::a!@#,,ASASASASASAg,,,j"g,,,j;;;,,,,,,,;dfcverdf;;;;;;;;g,,,j"
"g,,,jQWQWQ:::::[!@#,,QWQWQWQWQWQg,,,j"g,,,j;;;1222223;df;;dfcv;;;;;;;;g,,,j"
"g,,,jASASA122224!@#,,ASAerSASASAg,,,j"g,,,j;;;;;;;;;;;cv;;cv;;;;;;;;;;g,,,j"
"g,,,jQWQWQWQWQW4!@#,,QWQdfWQWQWQg,,,j"g,,,j;;;;;;;;;;;;;;;;;;;;;;;;;;;g,,,j"
"g,,,jASASASASAS4!@#,,ASAdfSASASAg,,,j"g,,,j;;7888888888888889;;;;;;;;;g,,,j"
"g,,,jQWQWQWQWQWz!@#,,QWQdferWQWQg,,,j"g,,,j;;aXXXXXXXXXXXXXXX;;;;;;;;;g,,,j"
"g,,,jASASASASAS122223ASAcvdfSASAg,,,j"g,,,j;;[XXXXXXXXXXXXXXX;;;;;;;;;g,,,j"
"g,,,jQWQWQWQWQWQWQWQWQWQWQdfWQWQg,,,j"g,,,j;;4XXXXXXXXXXXXXXX;;;;;;;;;g,,,j"
"g,,,jASASAerSASASASASASASAcvSASAg,,,j"g,,,j;;zXXXXXXXXXXXXXXX;;;;;;;;;g,,,j"
"g,,,jQWQWQdfWQWQWQWQWQWQWQWQWQWQg,,,j"g,,,j;;1222222222222223;;;;;;;;;g,,,j"
"g,,,jASAerdfSASASASA789ASASASASAg,,,j"g,,,j;;;;;;;;;;;;;;;;;;;;;;;;;;;g,,,j"
"g,,,jQWQdfcvWQWQWQWQ,,sQWQWQWQWQg,,,j"g,,,j;;;;;;;;;788888889;;;;;;;;;g,,,j"
"g,,,jASAdfSASASASASA,,]ASASASASAg,,,j"g,,,j;;;;;;;;;a7888888889;;;;;;;g,,,j"
"g,,,jQWQdfWQWQWQWQWQ,,6QWQWQWQWQg,,,j"g,,,j;;;;;er;;[a....|....;;;;;;;g,,,j"
"g,,,jASAcvSASASASASA,,6ASASASASAg,,,j"g,,,j;;;;;cv;;44....|....;;;;;;;g,,,j"
"g,,,j{==^======================}g,,,j"g,,,j{====^====================}g,,,j"
"g,,,,yyyyyyyyyyyyyyyyyyyyyyyyyyy,,,,j"g,,,,yyyyyyyyyyyyyyyyyyyyyyyyyyy,,,,j"
"g,,,,,,,,,,,,,,,,,,,,,,,,,,,,,,,,,,,j"g,,,,,,,,,,,,,,,,,,,,,,,,,,,,,,,,,,,j"
"g,,,,,,,,,,,,,,,,,,,,,,,,,,,,,,,,,,,j"g,,,,,,,,,,,,,,,,,,,,,,,,,,,,,,,,,,,j"
"g,,,,,,,,,,,,,,,,,,,,,,,,,,,,,,,,,,,j"g,,,,,,,,,,,,,,,,,,,,,,,,,,,,,,,,,,,j"
"bnnnnnnnnnnnnnnnnnnnnnnnnnnnnnnnnnnnm"bnnnnnnnnnnnnnnnnnnnnnnnnnnnnnnnnnnnm"
"""""""""""""""""""""""""""""""""""""""""""""""""""""""""""""""""""""""""""""
"tyyyyyyyyyyyyyyyyyyyyyyyyyyyyyyyyyyyu"tyyyyyyyyyyyyyyyyyyyyyyyyyyyyyyyyyyyu"
"g,,,,,,,,,,,,,,,,,,,,,,,,,,,,,,,,,,,j"g,,,,,,,,,,,,,,,,,,,,,,,,,,,,,,,,,,,j"
"g,,,,,,,,,,,,,,,,,,,,,,,,,,,,,,,,,,,j"g,,,,,,,,,,,,,,,,,,,,,,,,,,,,,,,,,,,j"
"g,,,,,,,,,,,,,,,,,,,,,,,,,,,,,,,,,,,j"g,,,,,,,,,,,,,,,,,,,,,,,,,,,,,,,,,,,j"
"g,,,,nnnnnnnnnnnnnnnnnnnnnnnnnnn,,,,j"g,,,,nnnnnnnnnnnnnnnnnnnnnnnnnnn,,,,j"
"g,,,j...............,,6.........g,,,j"g,,,j'''''''''44....|....'''''''g,,,j"
"g,,,j.........788889,,x.....OO..g,,,j"g,,,j''er'''''44-D--/....'''OO''g,,,j"
"g,,,j.........:,,,,s123.....CO..g,,,j"g,,,j''cv'''''44.........'''OC''g,,,j"
"g,,,j.........:,,,,6............g,,,j"g,,,j'''''''''4z-D-------'''''''g,,,j"
"g,,,j.........:,,,,]............g,,,j"g,,,j'''''''''41222222223'''''''g,,,j"
"g,,,j.........:,,,,6............g,,,j"g,,,j'''''''''4,,,,,,,,'''''''''g,,,j"
"g,,,j.........:,,,,x.....er.....g,,,j"g,,,j'''''''''4,,,,,,,,'''''''''g,,,j"
"g,,,j.........122223.....dfer...g,,,j"g,,,j'''''''''4,,,,,,,,'''''''''g,,,j"
"g,,,j....................cvcv...g,,,j"g,,,j'''''''''4,,,,,,,,'''''''''g,,,j"
"g,,,j...........................g,,,j"g,,,j'''''''''4,,,,,,,,'''''''''g,,,j"
"g,,,j...........................g,,,j"g,,,j'''''''''z,,,,,,,,'''''''''g,,,j"
"g,,,j...........................g,,,j"g,,,j'''''''''122222223'''''''''g,,,j"
"g,,,j...........................g,,,j"g,,,j'''''''''''''''''''''''''''g,,,j"
"g,,,j.....erererer..7888889.....g,,,j"g,,,j'''''''''''''''''''''''''''g,,,j"
"g,,,j.....dfdfdfdf..,!@#!@s.....g,,,j"g,,,j'''''''''''''''''788889''''g,,,j"
"g,,,j.....dfcvcvdf..,!@#!@6.....g,,,j"g,,,j'''''''''''''''''"""""s''''g,,,j"
"g,,,j.....df....df..,!@#!@].....g,,,j"g,,,j'''''''''''''''''"""""6''''g,,,j"
"g,,,j.....df....cv..,!@#!@6.....g,,,j"g,,,j'''''er''''''''''"""""x''''g,,,j"
"g,,,j.....df........,,,,,,x.....g,,,j"g,,,j'''''df''''''''''122223''''g,,,j"
"g,,,j.....cv........1222223.....g,,,j"g,,,j'''''cv''''''''''''''''''''g,,,j"
"g,,,j{====^====================}g,,,j"g,,,j{====^====================}g,,,j"
"g,,,,yyyyyyyyyyyyyyyyyyyyyyyyyyy,,,,j"g,,,,yyyyyyyyyyyyyyyyyyyyyyyyyyy,,,,j"
"g,,,,,,,,,,,,,,,,,,,,,,,,,,,,,,,,,,,j"g,,,,,,,,,,,,,,,,,,,,,,,,,,,,,,,,,,,j"
"g,,,,,,,,,,,,,,,,,,,,,,,,,,,,,,,,,,,j"g,,,,,,,,,,,,,,,,,,,,,,,,,,,,,,,,,,,j"
"g,,,,,,,,,,,,,,,,,,,,,,,,,,,,,,,,,,,j"g,,,,,,,,,,,,,,,,,,,,,,,,,,,,,,,,,,,j"
"bnnnnnnnnnnnnnnnnnnnnnnnnnnnnnnnnnnnm"bnnnnnnnnnnnnnnnnnnnnnnnnnnnnnnnnnnnm"
"""""""""""""""""""""""""""""""""""""""""""""""""""""""""""""""""""""""""""""
OBJECT
-----------------------------------------------------------------------------
-                                     -                                     -
-                                     -                                     -
-                                     -                                     -
-                                     -                                     -
-    -----------------------------    -    -----------------------------    -
-    -                           -    -    -                           -    -
-    - F   --------              -    -    - F -------                 -    -
-    -     [ f f 0123            -    -    -   [    N] qw              -    -
-    - N   [     4567            -    -    - N [     ] qw              -    -
-    -     [ f f-e----           -    -    -   [     ] ASqw  qw        -    -
-    - c   [    -    ]           -    -    - c [     ] qwASQWqw        -    -
-    -     [    -    ]           -    -    -   ------- qw  asqw        -    -
-    - t   ------    ]   QW      -    -    - t         qw  qw          -    -
-    -          -    ]   qw      -    -    -                           -    -
-    -          -    ]   qw      -    -    -  -x--------------         -    -
-    -          -    ]   ASqw    -    -    -  -              ]         -    -
-    -          ------   qwqw    -    -    -  -              ]         -    -
-    -                     qw    -    -    -  -              ]         -    -
-    -     qw              qw    -    -    -  -              ]         -    -
-    -     qw                    -    -    -  ----------------         -    -
-    -   QWqw        ---         -    -    -                           -    -
-    -   asqw        [ -         -    -    -         ---------         -    -
-    -   qw          [ -         -    -    -         --g--------       -    -
-    -   qw          [ -         -    -    -     qw  --B  d t  ]       -    -
-    -   qw          [ -         -    -    -     qw  --b       ]       -    -
-    --!@#!@-------------------T--    -    --!@#!@-------------------T--    -
-                                     -                                     -
-                                     -                                     -
-                                     -                                     -
-                      * * * * *  O   -                    * * * * *   O    -
-                                     -                                     -
-----------------------------------------------------------------------------
-                                     -                                     -
-                                     -                                     -
-                                     -                                     -
-                                     -                                     -
-    -----------------------------    -    -----------------------------    -
-    -               [ -         -    -    -         --        ]       -    -
-    - F       -e----[ -     --  -    -    - FQW     --        ]   --  -    -
-    -         [    ----     --  -    -    -  qw     --        ]   --  -    -
-    - N       [    -            -    -    - N       --        ]       -    -
-    -         [    -            -    -    -         -----------       -    -
-    - c       [    -            -    -    - c       -f f f f]         -    -
-    -         [    -     QW     -    -    -         -       ]         -    -
-    - t       ------     QWqw   -    -    - t       -       ]         -    -
-    -                    asqw   -    -    -         -       ]         -    -
-    -                           -    -    -         -       ]         -    -
-    -                           -    -    -         -f f f f]         -    -
-    -                           -    -    -         ---------         -    -
-    -                           -    -    -                           -    -
-    -     QWqwASQW  -------     -    -    -                           -    -
-    -     qwqwqwqw  [     -     -    -    -                 ------    -    -
-    -     asasqwqw  [     -     -    -    -                 [F ff-    -    -
-    -     qw    qw  [     -     -    -    -                 [F ff-    -    -
-    -     QW    qw  [     -     -    -    -     QW          [F ff-    -    -
-    -     qw        [     -     -    -    -     qw          ------    -    -
-    -     qw        -------     -    -    -     qw                    -    -
-    --!@#!@-------------------T--    -    --!@#!@-------------------T--    -
-                                     -                                     -
-                                     -                                     -
-                                     -                                     -
-                      * * * * *  O   -                      * * * * *  O   -
-                                     -                                     -
-----------------------------------------------------------------------------
TEXT
3100 450 black 1 Netscape 6.0
EVENT
-----------------------------------------------------------------------------
-                                     -                                     -
-                                     -                                     -
-                                     -                                     -
-                                     -                                     -
-    -----------------------------    -    -----------------------------    -
-    -                           -    -    -                           -    -
-    -     --------          -B  -    -    - - EEEEEEE             A-  -    -
-    -     - - - ----        CD  -    -    -   E     E --          CD  -    -
-    -     -     ----            -    -    - - E     E --              -    -
-    -     - - -------           -    -    -   E     E ----  --        -    -
-    - -   -    -    -           -    -    - - E     E --------        -    -
-    -     -   J-    -           -    -    -   EEEEEEE --  ----        -    -
-    - -   ------    -   --      -    -    - -         --  --          -    -
-    -       M  -    -   --      -    -    -                           -    -
-    -       M  -    -   --      -    -    -  ----------------         -    -
-    -       M  -    -   ----    -    -    -  -              -         -    -
-    -       MMM------   ----    -    -    -  -              -         -    -
-    -                     --    -    -    -  -              -         -    -
-    -     --              --    -    -    -  -              -         -    -
-    -     --                    -    -    -  ----------------         -    -
-    -   ----        ---         -    -    -                           -    -
-    -   ----        - -         -    -    -         ---------         -    -
-    -   --          - -         -    -    -         -----------       -    -
-    -   --          - -         -    -    -     --  ---  - -  -       -    -
-    -   --          - -         -    -    -     --  ---       -       -    -
-    -----------------------------    -    -----------------------------    -
-                                     -                                     -
-                                     -                                     -
-                                     -                                     -
-                      - - - - -  -   -                    - - - - -   -    -
-                                     -                                     -
-----------------------------------------------------------------------------
-                                     -                                     -
-                                     -                                     -
-                                     -                                     -
-                                     -                                     -
-    -----------------------------    -    -----------------------------    -
-    -               - -         -    -    -         --   I-  E-       -    -
-    - -       ------- -     AB  -    -    - ---     --- ---   -   AB  -    -
-    -         -    ----     -D  -    -    -  --     --        -   C-  -    -
-    - -       -    -            -    -    - -       --- -------       -    -
-    -         -    -            -    -    -         -----------       -    -
-    - -       -    -            -    -    - -       -- - - --         -    -
-    -         -    -     --     -    -    -         -       -         -    -
-    - -       ------     ----   -    -    - -       -       -         -    -
-    -                    ----   -    -    -         -       -         -    -
-    -                           -    -    -         -       -         -    -
-    -                           -    -    -         -- - - --         -    -
-    -                           -    -    -         ---------         -    -
-    -                           -    -    -                           -    -
-    -     --------  -------     -    -    -                           -    -
-    -     --------  -     -     -    -    -                 ------    -    -
-    -     --------  -     -     -    -    -                 -- ---    -    -
-    -     --   I--  -     -     -    -    -                 -- ---    -    -
-    -     --    --  -     -     -    -    -     --          -- ---    -    -
-    -     --        -     -     -    -    -     --          ------    -    -
-    -     --        -------     -    -    -     --                    -    -
-    -----------------------------    -    -----------------------------    -
-                                     -                                     -
-                                     -                                     -
-                                     -                                     -
-                      - - - - -  -   -                      - - - - -  -   -
-                                     -                                     -
-----------------------------------------------------------------------------
EVENTMETA
# Desktop switching
TELEPORT A y y n y 29  7 224 0
TELEPORT B y y n y 68  7  32 0
TELEPORT C y y n y 29 40 160 0
TELEPORT D y y n y 68 40  96 0

$MESSAGE M y n y y First let me check Slashdot... Which desktop did I leave netscape in?

# Into the folder in desktop A
TELEPORT I y y y y 14 12 192 0
TELEPORT J y y y y 13 57  32 0
#TELEPORT K y y y y 57 38 192 0
ENDLEVEL E y y n y slashdot.map

ENTITY
SPAWN   896  960 192   0
%SPAWN  384  384  96   0
%SPAWN 1344  576  32   0
%SPAWN 2816  384  64   0
%SPAWN  640  339 224   0
%SPAWN 4288 3456   0   0
%SPAWN 2112 1600   0 224

E 608 960 0 0

RAILGUN 832 768 192 0

$BUG 3776 2560 0 0
$BUG 3840 2560 0 0
$BUG 3904 2560 0 0
