EOF
32 26
default.table
Dave Lawrence
BASE
````````````````````````````````
````````````````````````````````
````````````````````````````````
````````````````````````````````
````````````````````````````````
````````````````````````````````
````````````````````````````````
````````````````````````````````
`SSSSSSSSSSSSSSSSSSSSSSSSSSSSSSS
````````````````````````````````
````````````````````````````````
````````````````````````````````
````````````````````````````````
````````````````````````````````
````````````````````````````````
````````````````````````````````
````````````````````````````````
`SSSSSSSSSSSSSSSSSSSSSSSSSSSSSSS
````````````````````````````````
````````````````````````````````
````````````````````````````````
````````````````````````````````
````````````````````````````````
````````````````````````````````
````````````````````````````````
````````````````````````````````
OBJECT
--------------------------------
--------------------------------
--------------------------------
--------------------------------
--------------------------------
--------------------------------
--------------------------------
--------------------------------
-                               
--------------------------------
--------------------------------
--------------------------------
--------------------------------
--------------------------------
--------------------------------
--------------------------------
--------------------------------
-                               
--------------------------------
--------------------------------
--------------------------------
--------------------------------
--------------------------------
--------------------------------
--------------------------------
--------------------------------
EVENT
--------------------------------
--------------------------------
--------------------------------
--------------------------------
--------------------------------
--------------------------------
--------------------------------
--------------------------------
-      A      ab         c     T
--------------------------------
--------------------------------
--------------------------------
--------------------------------
--------------------------------
--------------------------------
--------------------------------
--------------------------------
-           d      e     W     E
--------------------------------
--------------------------------
--------------------------------
--------------------------------
--------------------------------
--------------------------------
--------------------------------
--------------------------------
EVENTMETA
message A y n y y Huh? Where am I?
lookat a y n y y 128 And what does that say down there? EOF... End of File!
message b y n y y Is this really the end? Will the computer users of the world remain mere pawns under the dark will of Microsoft? (that's bad)
message c y n y y You don't want that, do you? Of course not. But in order to continue, some more levels need to be made.
message d y n y y You don't need to be a programmer to make maps or alter the gameplay of XTux, see the pages in "docs/" for more info.
message e y n y y Send your levels, appreciated words of encouragement & feedback to the developers on the webpage xtux.sourceforge.net
message W y n y y <INFO> That's http://xtux.sourceforge.net. Goodbye (game over!).
teleport T y y y y 1 17 64 0
endlevel E y y y y end.map
ENTITY
SPAWN 64 512 64 0
