#Based on the map Office space by James Andrews
GeekUSA
31 24
generic.table
James Andrews & Dave Lawrence
OBJECTIVE
type ELIMINATE_CLASS
class BADDIE
nextmap my_way_home.map
BASE
7-----------------------------9
|t""""''''''''''''''''''''''''|
|g"""8''ASS'D'''ASS'AS'SA'SD''|
|g"""|''Z'''C'''Z'''Z'''Z''Z''|
|g"""|''Z'''C'''Z'''Z'''Z''Z''|
|b""r|''Z'''C'''Z'''Z'''Z''Z''|
|"""r|''ASSSD'''ASSSASSSASSD''|
|"""r|''Z'''C'''Z'''Z'''Z''Z''|
|"""r|''Z'''C'''Z'''Z'''Z''Z''|
|"""r|''Z'''C'''Z'''Z'''Z''Z''|
|""4-3''SSS'S'''SSS'SS'SS'SS''|
|'''''''''''''''''''''''''''''|
|'''''''''''''''''''''''''''''|
|''AS'SAS'SDA'SD''''''''''''''|
|''Z'''Z'''CZ''C''''''''''''''|
|''Z'''Z'''CZ''C'''7------v---{
|''Z'''Z'''CZ''C'''2''''''|;;;|
|''ASSSDSSSSASSD''''''''''|;;;|
|''Z'''Z''''Z''C'''|'''t''2;;;|
|''Z'''Z''''Z''C'''|'''g'';;;;|
|''Z'''Z''''Z''C'''|'''g''|;;;|
|''SS'SSS'SSS'SS'''|'''g''|;;;|
|''''''''''''''''''|'''g''|;;;|
1------------------^-6'4--^---3
OBJECT
-------------------------------
-                            P-
-m   -  ---.-   ---.-W.--.--  -
-    -  p   -   -G  -   \  -  -
-   k-  cx  -   \   -   cx -  -
-   --  \   -   cx  cx  -  -  -
-   s-  --W--   ------------  -
-   m-  cx G-   -   cx  cx -  -
-   --  p   -   cx  -   -  -  -
-   s-  -   -   -   \   m  -  -
-  ---  ---.-   ---.--.--.--  -
-                             -
-                             -
-  --.---.---.--              -
-  \   c   \-  -              -
-  c   -   mcx -   ------------
-  -x  cx  -\  -   -fg   G- ##-
-  -------------          -   -
-  c  Gc  ##cx -   -   c  -   -
-  -   -x   -  -   -   pC     -
-  \x  p    -  -   -   c  -   -
-  --.---.---.--   -   pC -   -
-                  -P  -  -   -
---------------------~ --------
TOPLEVEL
-------------------------------
-                             -
-    -  --- -   -- --- -- --  -
-    -  -   -   -  --  --  -  -
-    -  -   -   -  --  --  -  -
-   --  -   -   -  --  --  -  -
-   --  -----   ------------  -
-   --  -   -   -  --  --  -  -
-   --  -   -   -  --  --  -  -
-   --  -   -   -  --  --  -  -
-  ---  --- -   -- --- -- --  -
-                             -
-                             -
-  -- --- --- --              -
-  -  --   --  -              -
-  -  --   --  -   ------------
-  -  --   --  -   -      -   -
-  -------------   _      -   -
-  -  --   --  -   -   -  -   -
-  -  --   --  -   -   -  _   -
-  -  --   --  -   -   -  -   -
-  -- --- --- --   -   -  -   -
-                  -   -  -   -
---------------------- --------
EVENT
-------------------------------
-                             -
-    -  --- -   -- --- -- --  -
-    -  -   -   -  --  --  -  -
-    -  -   -   -  --  --  -  -
-   --  -   -   -  --  --  -  -
-   --  -----   ------------  -
-   --  -   -   -  --  --  -  -
-   --  -   -   -  --  --  -  -
-   --  -   -   -  --  --  -  -
-  ---  --- -   -- --- -- --  -
-                             -
-                             -
-  -- --- --- --              -
-  -  --   --  -              -
-  -  --   --  -   ------------
-  -  --   --  -   -      -   -
-  -------------   _      -   -
-  -  --   --  -   -   -  -   -
-  -  --   --  -   -   -  _   -
-  -  --   --  -   -   -  -   -
-  -- --- --- --   -AAA-  -   -
-                  -   -  -   -
---------------------- --------
EVENTMETA
$message A y n y y No Microsofties get out of here alive.
ENTITY
SPAWN 1408 1472 0 200
%SPAWN 256 192 224 0
%SPAWN 1344 256 32 0
%SPAWN 1664 448 128 0
%SPAWN 1536 1024 128 0
%SPAWN 1344 896 0 0
%SPAWN 704 1216 192 0

#Single player monsters
#Top cubicles
MSCP 704 256 0 0
MSCP 1216 256 0 0
MSCP 1408 256 0 0
MSCP 1600 320 0 0
MSCP 704 512 128 0
MSCP 1216 512 128 0
MSCP 1408 512 128 0
MSCP 1600 512 128 0
#Passage ways
CLIPPY 896 128 0 0
CLIPPY 896 640 128 0
#Bottom Cubicles
MSCP 320 960 0 0
MSCP 576 960 0 0
MSCP 832 1024 0 0
MSCP 320 1216 128 0
MSCP 576 1216 128 0
MSCP 832 1216 128 0

MSCP 64 1152 0 0
MSCP 128 1152 128 0
MSCP 128 1408 64 0
MSCP 256 1408 64 0

BORG 960 192 128 0

CLIPPY 1856 704 192 0
MSCP 1856 768 192 0

NODOZE 1290 1300 0 0
CAN 128 50 0 0
CAN 160 50 0 0
SHOTGUN 1540 1420 0 0
SHOTGUN 576 320 0 0
SHELLS 576 192 0 0
CHAINGUN 1856 128 0 0
CHAINGUN 320 1152 0 0
RAILGUN 960 704 0 0
BULLETS 1872 1376 0 0
BULLETS 1872 1424 0 0
SHELLS 1824 1424 0 0
SLUGS 80 370 0 0
BULLETS 590 1036 0 0
BULLETS 1424 448 0 0
