# Home.map
# Created by James Andrews & Dave Lawrence
# Designed as an introductionary level. 
@ $HOME with Tux.
42 21
default.table
James Andrews & Dave Lawrence
BASE
..........................................
..........................................
...../-----------T--T------------\........
.....|:::::::::::V::VMMMMMMMMMMMM|........
.....|::::::::::::::MMMMMMMMMMMMM|........
.....|:::::::::::|::|MMMMMMMMMMMM|........
.....<----------->::(------------)........
.....|:::::::::::|::::::::::::::::SSSSSSSS
.....|:::::::::::|::/------------\........
.....|:::::::::::V::V::::::::::::|........
.....|:::::::::::::::::::::::::::|........
.....|::::::|::::|::|::::::::::::|........
.....|::::::|::::|::|::::::::::::|........
.....(------U---->::(------------>........
.....CCCCCCCCCCCC|mmmmmmmmmmmmmmK|........
.....CCCCCCCCCCCCVmmmmmmmmmmmmmmK|........
.....CCCCCCCCCCCCmmmmmmmmmmmmmmmK|........
.....CCCCCCCCCCCC|mmmmmmmmmmmmmmK|........
.....CCCCCCCCCCCC(---------------)........
..........................................
..........................................
OBJECT
------------------------------------------
-                                        -
-    --+-?--@--!---------+---t----       -
-    - Bb     d D-  - L -        -       -
-    -                    0      -   f   -
-    -           -  -s         Ww-       -
-    -------------  --------------     f -
-    - Cc      V -                gggggggg
-    -           -  ----$---------       -
-    -           -  -DD     P  Pd-       -
-    -                           -       -
-    -   Th      -  -            -       -
-    -   h       -  -            -       -
-    -------------  --R-----------       -
-                -    r         ^-       -
-                -          Th  S-       -
-                           h   --       -
-                -              K-       -
-                -----------------       -
-                                        -
------------------------------------------
TOPLEVEL
------------------------------------------
-                                        -
-    -----------------------------       -
-    - --     - --  - - -        -   F   -
-    -           _  _            -       -
-    -           -  --         ---     F -
-    -------------  --------------       -
-    - --      - -                        
-    -           -  --------------       -
-    -           -  ---     -  ---       -
-    -           _  _            -       -
-    -   --      -  -            -       -
-    -   -       -  -            -       -
-    -------------  --------------       -
-                -    -         --       -
-                -          --  --       -
-                _          -   --       -
-                -              --       -
-                -----------------       -
-                                        -
------------------------------------------
EVENT
------------------------------------------
-                                        -
-    -----------------------------       -
-    - --     - --  - - -        -       -
-    -                           -       -
-    -           -  --         ---       -
-    -------------  --------------       -
-    - --      - -  E               M    N
-    -           -  --------------       -
-    -           -  ---     A  W--       -
-    -           E  E            -       -
-    -   --      -  -            -       -
-    -   -       -EE-            -       -
-    -------------  --------------       -
-                -    -         --       -
-                -          --  --       -
-                           -   --       -
-                -              --       -
-                -----------------       -
-                                        -
------------------------------------------
EVENTMETA

$message M y n y y <NEWSPAPER> "Windows World Domination Edition Released!"
$message E y n y y Note to self: Check my email.
$map_target A y n y y <EMAIL> 1 41 7 Activity seems to be concentrated in an office complex across town. Check it out.
$message W y n y y <EMAIL> "Arghh! They're coming out of the God damned walls!"
endlevel N y n n y unfinished_sympathy.map
ENTITY
SPAWN 448 256 64 0
%CHAINSAW 2368 320 0 0
%SPAWN 64 64 96 0
%SPAWN 2560 64 160 0
%SPAWN 832 768 32 0
%SPAWN 1152 192 128 0
%SPAWN 1024 1152 0 0
