# Tux's house after MS has trashed it.
Home sweet.... Jesus!
42 21
trashed.table
James Andrews & Dave Lawrence
BASE
..........................................
..........................................
...../-----------T--T------------\........
.....|:::::::::::V::VMMMMMMMMMMMM|........
.....|::::::::::::::MMMMMMMMMMMMM|........
.....|:::::::::::|::|MMMMMMMMMMMMx........
.....<----------->::(--------xxxxx....x...
.....|:::::::::::|:::::::::::xxx::SSSSxSSS
.....|:::::::::::|::/------------\...x....
.....|:::::::::::V::V::::::::::::|..x.....
.....|:::::::::::::::::::::::x:::|........
.....|::::::|::::|::|:::::::x::::|........
.....|::::::|::::|::|::::::::::::|........
.....(------U---->::(------------>........
.....CCCCCCCCCCCC|mmmmmmmmmmmmmmK|........
.....CCCCCCCCCCCCVmmmmmmmmmmmmmmK|........
.....CCCCCCCCCCCCmmmmmmmmmmmmmmmK|........
.....CCCCCCCCCCCC|mmmmmmmmmmmmmmK|........
.....CCCCCCCCCCCC(---------------)........
..........................................
..........................................
OBJECT
------------------------------------------
-                                        -
-    --+-M--M--M---------+---M----       -
-    - Bb     d D-  - L -        -       -
-    -     x              0    xx-   .   -
-    -      x    -  -s        xWw x    . -
-    -----M-------  -----Zz--     x  x   -
-    - Cc      V -     x        xxgggg ggg
-    -           - x-----M----M---    xx -
-    -       x   -  -DD     P  pd-    x  -
-    -        x             x    -       -
-    -   Th      -  -            -       -
-    -   h       -  -  x         -       -
-    -------------  --R------M----       -
-                -    r         ^-       -
-                - x        Th  S-       -
-                      x    h   --       -
-                -              K-       -
-                -----------------       -
-                                        -
------------------------------------------
TOPLEVEL
------------------------------------------
-                                        -
-    -----------------------------       -
-    - --     - --  - - -        -       -
-    -           _  _            -       -
-    -           -  --         --        -
-    -------------  ---------            -
-    - --      - -                        
-    -           -  --------------       -
-    -           -  ---     -  ---       -
-    -           _  _            -       -
-    -   --      -  -            -       -
-    -   -       -  -            -       -
-    -------------  --------------       -
-                -    -         --       -
-                -          --  --       -
-                _          -   --       -
-                -              --       -
-                -----------------       -
-                                        -
------------------------------------------
EVENT
------------------------------------------
-                              B         -
-    -----------------------------B      -
-    - --   b - --  - - -        - B     -
-    -bbbbbbb        tttttt      -  B    -
-    -           -  --         --   B    -
-    -------------  ---------       B    -
-    - --      - -     C            B   A 
-    -           -  --------------  B    -
-    -           -  --- D   E   --  B    -
-    -                   D       -  B    -
-    -   --      -  -    D       -  B    -
-    -   -       -  -    D       -  B    -
-    -------------  --------------  B    -
-                -    -         --  B    -
-                -     m    --  --  B    -
-                           -   --  B    -
-                -              -- B     -
-                -----------------B      -
-                                B       -
------------------------------------------
EVENTMETA
$message A y n y y Oh my god.....
$message B y n y y Those bastards!
$message C y n y y My computers!?
$message D y n y y Looks like this one still works. Time to get online.
$endlevel E y n n y desktop.map
$message t y n y y They've trashed my toilet!
$message b y n y y They've burned my bed!
$message m y n y y My house... those posters.... this godawful softdrink... these monsters have no shame, or taste.
ENTITY
SPAWN 2624 448 192 200
BADCAN 1472 960 0 0
