#Hecho por Arturo Garro
#mailto:arturog@costarricense.com
#Send Greetings Only.
#Envie solo saludos.
#
Laberinto
75 40
default.table
Arturo Garro
BASE
XXXXXXXXXXXXXXXXXXXXXXXXXXXXXXXXXXXXXXXXXXXXXXXXXXXXXXXXXXXXXXXXXXXXXXXXXXX
X.,.,.,.,.,.,.|.,.,.,,.,.,.,.,.,.,.,.,.|.,.,.,.,/-----.,.,.,|,.,.,|,.,.,.,X
X.------------).----\.--,|,----T------,,.------,|,.,.,.,.,|,.,|.,.|,/-----X
X....,.,.,.,.,.,.,.,|,.,.|.,.,.|.,.,.,.|,.,.,.,.|,/--,----U---),.,.,|,.,.,X
X.-T-.---.-./---..|.<----U-T--,|,/---.,|./-T-\./),|,.,.,.,.,.,.,.|.,.,.,.,X
X..|........|.....|,|......|..|..|..,....|.|.|.|..|./------------).|.,----X
X..|./------>./-\.<-).---T-)..|.-U-./---.|.,.|.|..|.|..............(-,.,..X
X.->.|......|.|.|.|......|...->.....|....|.|.|.|...,|.-T--------.|....----X
X..|.|.-T-\.|......,...|.,..|.|.---.|.|..|.|...|.|..|..|.........|.--.....X
X-.|.|..|.|...---------U--.-U->.....(-U-.|.|...|.|..|..|.|..|....|....---.X
X..|.|.|........,.....,.......<----........|.--).|..|..|.<--U-.|../--.....X
X.-).|...-T----T-------------.|..,..|......|...,....|.-).|.....|..|....|..X
X....|....|....|.............,......|./---....------>................--U--X
X.--->./--)....<-----T-T-T--------T-).|..,......,...|.-T-,-T--------......X
X....|.|.......|.....|.|.|...,....|...<-----T------.|..|...|.........|....X
X---.|.<------...-T-.|.|.|.,...|..|...|.....|.......|..|.....|....|..|....X
X....|.|.......|..|..|.|...----)..|.......|.|.------>.-U----.(-T--).......X
X....|.|.-----.|..|..|.|....,.....|../----).|...,...|..........|....|.....X
X..-->.........|..|.....,--------....|......<---....|..------\......|.....X
X....<-T------..,-U----......,....|..<------)..,..,.|........|.-----U---..X
X.--.|.|.,.............,|.-\....|.(-.<-........----->.....................X
X....|.<----T-------.,..|..|....|....(--------......<-------.|..|.........X
X--..|.|....|...........|..(-\.-U-....,........----.|........|..|.........X
X....|.|.|..|.----------)....|.......|.---T---......|.------......./--T-..X
X.---).|.|..|......,......|..<-.|.---)....|....,...->........|.-\..|..|...X
X......|.|,,(---T-------\.|..|.........---U-T----...|..------)..|..|..,...X
X-T---.|.|..,...|..,....|...-U-..---\...,...|...,..->...........<--U-..|..X
X.|....,.|..,..,..|...,...|..,..,...|....,....,.....|...----.|..|......|..X
X.(-T----U-----T--U--T----U---------U--------------.|........|..|..----U-.X
X...|.,..,.....|...,.|.....,......,.........,.......|.---\................X
X...|.--T----\.|..|..|.../----,---T---,-----.-T---..|....<--T-----\...----X
X...|...|....|.|..|.,....|........|...........|.....|....|..|.....|.......X
X./-).-->.--.|.(--U-T----).|....|.|.--T-\.......|.....---)........|....|..X
X.|.....|....|......|.....,|....|.|...|.<-------)...|.........---->..,.|..X
X.<----.(-T-.|......|......|....|.....|.|...........|...|.........|..--U--X
X.|.......|....----->,,....(--T-U----->.|...---T----U-..|....|.,..........X
X.|.|...............|.........|.......|.|.|....|........|....|...|..,.....X
X.|....--------\....(-----....|.-----,..|.|..|.|....|.,.....-U--->.,......X
X..............|..........................|..|......|............|........X
XXXXXXXXXXXXXXXXXXXXXXXXXXXXXXXXXXXXXXXXXXXXXXXXXXXXXXXXXXXXXXXXXXXXXXXXXXX
OBJECT
---------------------------------------------------------------------------
-            P                                                            -
-     ?                           @        +                          !   -
-                                                      +                  -
-                      !                                                  -
-                                                                         -
-                                                                         -
-                                                                         -
-                                                                         -
-                !                                                        -
-                                                                         -
-                   ?                                                     -
-                                              ?                          -
-                                                                         -
-                                                                         -
-                                                                         -
-                                                                         -
-                                                                         -
-                                                                         -
-                                                                         -
-                                                                         -
-                                                                   Cc    -
-                                                                         -
-                                                                         -
-                                                                         -
-                                                                         -
-                                                                         -
-                                                                         -
-                                              ?                          -
-                                                                         -
-                                                                         -
-                                                                         -
-                                                                         -
-                                                                         -
-                                                                         -
-                                                                         -
-                                                                      F  -
-                                                                      f  -
-                                                                         -
---------------------------------------------------------------------------
ENTITY
SPAWN 64 64 0 0

#---------------------------------------------------------------------------
#-S          c                 C   P        C                         P   c-
#-                                                                         -
#-                       P             C                                   -
#-                  L                                  T      P            -
#-            T     c                                                      -
#-                                          n          T                   -
#-          P                   L     T                              P     -
#-P             R R   P               c  C     C    P  L                   -
#-   P                                                        L            -
#-                    C                                           T        -
#-                                                 P                       -
#-                                                             L           -
#-P                                     c    C      T                      -
#-                     c c                                                 -
#-                                   P                                     -
#-         L                                                               -
#-                                                                         -
#-                     P C                         T             L         -
#-                                                           P             -
#-     c                                                               CTcc-
#-     L                                                               PLcc-
#-     R                                                                   -
#-                                                                         -
#-                                                                         -
#-                                C                               Tc       -
#-                    P                                      L             -
#-                                           P T                           -
#-                                                                         -
#-                            L     RRTRRR                                P-
#-                      P                                                  -
#-                                     L        T                T       L -
#-                                                           P             -
#-  c                        L                     L                       -
#-                CR   LTL                                                 -
#-                                                                        L-
#-                                                                      RRR-
#-                                                                   R    R-
#-    P       Lc  T                CLPTR     L  P       L  T        RRR   P-
#---------------------------------------------------------------------------
