Mapedit test map
100 35
default.table
Milo van Handel
BASE
....../------------------------\./--------T---------\...............................................
......|::::::::::::::::::::::::|.|::::::::|:::::::::(\..............................................
......|::::::::::::::::::::/-\:|.|::::::|:|:/---T-\::(\........./---\...............................
......|::::::::::::::::::::|.|:|.|::::::|:|:|:::|.(\::(\......./):::(\..............................
......|:/-------\::::::::::|.|:|.|::::::|:|:|:|:|..(\::(\...../):::::(\.............................
......|:|.......|::::::::::|.|:|.|::::::|:|:|:|:|...(\::(\.../):::::::(\............................
/-----):(-----\.|::::::::::|.|:|.|::::::|:|:|:|:|....(\::(---):::::::::(---\........................
|:::::::::::::|.(--------\:|.|:|.|::::::|:|:|:|:|./-\.(\:::::::::::::::::::|........................
|:/---------\:|..........|:|.|:|.|::::::|:|:|:|:|.|:(\.(-----\:::::::::/-\:|........................
|:|.........|:|..........|:|.|:|.|::::::|:|:|:|:|.|::(\......(\:::::::/U->:|........................
|:|./-----\.|:|../-----\.|:|.|:|.|::::::|:|:|:|:|.|:::(-----\.(\:::::/)::|:|........................
|:|.|:::::|.|:(--):::::|.|:|.|:|.|::::::|:|:V:|:|.|:::::::::(\.(\:::/):::|:|........................
|:|.|:::::|.|::::::/-\:|.|:|.|:|.|::::::|:|:::|:|.|::::::::::(\.(---)::::|:|........................
|:|.|:::::|.(------U->:|.|:|.|:|.(----\:|:(---):|.|:::::::::::(\:::::::::|:|........................
|:V.|:::::|..........|:|.|:|.|:|......|:|:::::::|.|:::::::::|::(------:-->:|........................
|...|:::::<----------):(-U-U-):(------):(------->.|:::::::::|::::::::::::|:|........................
U---U--:--):::::::::::::::::::::::::::::::::::::|.|:::::::::|::::::::::::|:(---------\..............
:::::::::::::/---------------\:/-------:-------:|.|:::::::::|::::::::::::|:::::::::::|..............
-------T--:-->...............|:|mmmmmmmmmmmmmmmm|.(---\:/---)::::::::::::|:/-------\:|..............
.......|MMMMM|./-\./-\./--\..|:|mmmmmmmmmmmmmmmm|.....|:|::::::::::::::::|:|.......|:|..............
./-----)MMMMM|.|.|.|.|.|..V..|:|mmmmmmmmmmmmmmmm<-----):(----------------):|.......|:|..............
.|mmmmmmMMMMM|.|.(T).|.(--\..|:|mmmmmmmmmmmmmmmm|::::::::::::::::::::::::::|.......|:(--------------
.(-----\MMMMM|.|..V..|....|..|:|mmmmmmmmmmmmmmmm<----T--------:-----T----\:|.......|::::::::::::::::
.......|MMMMM|.V.....V.(--)..|:|mmmmmmmmmmmmmmmm|MMMM|MMMMMMMMMMMMMM|MMMM|:|.......(----------------
.......<-:---U-U-----U-----\.|:|mmmmmmmmmmmmmmmm|MMMM|MMMMMMMMMMMMMM|MMMM|:|........................
.......|:::::::::::::::::::|.|:|mmmmmmmmmmmmmmmm|M/-M|MMMMMMMMMMMMMM|M-\M|:|........................
.......|::::::::::::::::::/).|:|mmmmmmmmmmmmmmmm|M|MM|MMMMMMMMMMMMMM|MM|M|:|........................
.......|:::::::::::::::::/)..|:|mmmmmmmmmmmmmmmm|M|MM|MMMMMMMMMMMMMM|MM|M|:|........................
.......(--------------\:/)../):|mmmmmmmmmmmmmmmm|M(--)MMMMMMMMMMMMMM(--)M|:|........................
......................|:|../)::|mmmmmmmmmmmmmmmm|MMMMMMMMMMMMMMMMMMMMMMMM|:|........................
......................|:|./)::/)mmmmmmmmmmmmmmmm<------------------------>:|........................
......................|:|.|::/)mmmmmmmmmmmmmmmmm|........................|:|........................
......................|:(-):/)mmmmmmmmmmmmmmmmmm|........................|:|........................
......................|:::::|mmmmmmmmmmmmmmmmmmm|........................|:|........................
......................(-----U-------------------)........................(-)........................
OBJECT
----------------------------------------------------------------------------------------------------
------------------------------.---------.-----------------------------------------------------------
----------------------------------------------------------------------------------------------------
----------------------------------------------------------------------------------------------------
-------.--------------------------------------------------------------------------------------------
-------.--------------------------------------------------------------------------------------------
-------.--------------------------------------------------------------------------------------------
--------------------------.----------------------------------.---------....-------------------------
----------------------------------------------------------------------------------------------------
----------------------------------------------------------------------------------------------------
----------------------------------------------------------------------------------------------------
----------------------------------------------------------------------------------------------------
------------------------------------------------------------.---------------------------------------
---------------------------------------.--------------------.---------------------------------------
---------------------------------------.------------------------------.-----------------------------
----------------------.-------.-----M--.------------------------------------------------------------
-------.-----------------------.--------------------------------------------------------------------
------------------------------.--------.-M-----.---------------------------.--------.---------------
----------.-----------------------------------------------------------------------------------------
----------------------------------------------------------------------------------------------------
-------------------------------------------------------.--------------------------------------------
-------------------------------------------------------------------------.-------------------M------
--------------------------------------------------------------.-------------------------------------
----------------------------------------------------------------------------------------------------
---------.----------M-------------------------------------------------------------------------------
------------.---------------------------------------------------------------------------------------
------------.---------------------------------------------------------------------------------------
------------.---------------------------------------------------------------------------------------
-----------------------.------.---------------------------------------------------------------------
----------------------------M-----------------------------------------------------------------------
----------------------------------------------------------------------------------------------------
----------------------------------------------------------------------------------------------------
----------------------------------------------------------------------------------------------------
----------------------------------------------------------------------------------------------------
----------------------------------------------------------------------------------------------------
TOPLEVEL
----------------------------------------------------------------------------------------------------
----------------------------------------_-----------------------------------------------------------
----------------------------------------------------------------------------------------------------
----------------------------------------------_-----------------------------------------------------
----------------------------------------------------------------------------------------------------
----------------------------------------------------------------------------------------------------
----------------------------------------------------------------------------------------------------
----------------------------------------------------------------------------------------------------
----------------------------------------------------------------------------------------------------
----------------------------------------------------------------------------------------------------
----------------------------------------------------------------------------------------------------
----------------------------------------------------------------------------------------------------
----------------------------------------------------------------------------------------------------
------------------------------------------------------------_---------------------------------------
----------------------------------------------------------------------------------------------------
----------------------------------------------------------------------------------------------------
----------------------------------------------------------------------------------------------------
----------------------------------------------------------------------------------------------------
----------------------------------------------------------------------------------------------------
----------------------------------------------------------------------------------------------------
----------------------------------------------------------------------------------------------------
----------------------------------------------------------------------------------------------------
-----------------------_----------------------------------------------------------------------------
----------------------------------------------------------------------------------------------------
----------------------------------------------------------------------------------------------------
----------------------------------------------------------------------------------------------------
----------------------------------------------------------------------------------------------------
----------------------------------------------------------------------------------------------------
----------------------------------------------------------------------------------------------------
----------------------------------------------------------------------------------------------------
----------------------------------------------------------------------------------------------------
----------------------------------------------------------------------------------------------------
----------------------------------------------------------------------------------------------------
----------------------------------------------------------------------------------------------------
----------------------------------------------------------------------------------------------------
EVENT
----------------------------------------------------------------------------------------------------
----------------------------------------------------------------------------------------------------
----------------------------------------------------------------------------------------------------
----------------------------------------------------------------------------------------------------
----------------------------------------------------------------------------------------------------
----------------------------------------------------------------------------------------------------
----------------------------------------------------------------------------------------------------
----------------------------------------------------------------------------------------------------
----------------------------------------------------------------------------------------------------
------------------------------------------------------------------------l---------------------------
----------------------------------------------------------------------------------------------------
----------------------------------------------------------------------------------------------------
----------------------------------------------------------------------------------------------------
--------------------c-------------------------------------------------------------------------------
-A----------------------------b---------------------------------------J-----------------------------
------------------------------B--------I----a-------------------------------------------------------
-------------------------------B------H-H--<-C------------------------------------------------------
------------------------------G--------I-------H----------------------------------------------------
------------------------------g--------------h--------------------------------------L---------------
---------------------------------------------hhh----------------------------------------------------
--S-------------------------------------------------------------------------------------------------
------------------------------E---------------------------------------------------------------------
------------------------------e-------------------------------------------------------------------->
------------------------------f---------------------------------------------------------------------
---------D------------------------------------------------------------------------------------------
-----------T---------------------------------------j------------------k-----------------------------
--------TTTT----------------------------------------------------------------------------------------
----------------------------------------------------------------------------------------------------
------------------------------F------------------K--------------------------------------------------
----------------------------------------------------------------------------------------------------
----------------------------------------------------------------------------------------------------
----------------------------------------------------------------------------------------------------
-----------------------------i----------------------------------------------------------------------
----------------------------------------------------------------------------------------------------
----------------------------------------------------------------------------------------------------
EVENTMETA
DOOR D n n y n KEY=1 <DOOR_H> 
TRIGGER S y y y y KEY=1 <SWITCH> D n 1 
TRIGGER T y n n y KEY=1 D n -1 Hey!  Stay open, you stupid door!
DOOR E n n y n KEY=1 <DOOR_H> 
TRIGGER e y n n y KEY=1 E n 1 At least this one opens automatically...  COBOL inside!?
DOOR F n n y n KEY=1 <DOOR_H> 
TRIGGER f y n n y KEY=1 F y 1 
DOOR G n n y n KEY=1 <DOOR_H> 
TRIGGER g y n n y KEY=1 G n 1 Finally...
DOOR A n n y n KEY=1 <DOOR_H> 
TRIGGER a y y y y KEY=1 <SWITCH> A n 1 Nope, no effect visible.
DOOR B n n y n KEY=1 <DOOR_H> 
TRIGGER b y n n y KEY=1 B n 1 Was that long walk for nothing?  No, wait, the other door's opening too.
DOOR C n n y n KEY=1 <DOOR_H> 
TRIGGER c n y y y KEY=1 <SWITCH> C n 1 
TRIGGER < y n n y KEY=1 c n 1 Sigh, blocked.  But maybe that switch helps.
DOOR H y n y n KEY=1 <DOOR_H> 
TRIGGER h y n n y KEY=1 H n 1 NOW how do I get out of here?
DOOR I n n y n KEY=1 <DOOR_H> 
TRIGGER i y y y y KEY=1 <SWITCH> I n 1 
DOOR J n n y n KEY=1 <DOOR_H> 
TRIGGER j y y y y KEY=1 <SWITCH> J n 1 
DOOR K n n y n KEY=1 <DOOR_H> 
TRIGGER k y y y y KEY=1 <SWITCH> K n 1 
DOOR L n n y n KEY=1 <DOOR_H> 
TRIGGER l y y y y KEY=1 <SWITCH> L n 1 
ENDLEVEL > y n n y KEY=1 end.map
ENTITY
SPAWN 0 1088 64 0
COBOL 1928 1224 128 0
COBOL 1928 1288 128 0
COBOL 1928 1160 128 0
CLIPPY 843 1695 128 0
CLIPPY 1066 1693 128 0
CLIPPY 1178 1689 128 0
CLIPPY 956 1694 128 0
CLIPPY 1294 1687 128 0
CLIPPY 1426 1687 128 0
ZOMBIE 1494 1895 128 0
ZOMBIE 1496 1952 128 0
ZOMBIE 1486 2025 128 0
ZOMBIE 1488 2107 128 0
ZOMBIE 1547 2113 128 0
ZOMBIE 1600 2112 128 0
ZOMBIE 1657 2112 128 0
ZOMBIE 1702 2113 128 0
ZOMBIE 1746 2110 128 0
ZOMBIE 1743 2020 128 0
ZOMBIE 1804 1982 128 0
ZOMBIE 1808 1928 128 0
ZOMBIE 1870 1915 128 0
ZOMBIE 1927 1858 128 0
EGUN 475 843 128 0
BORG 382 833 128 0
MSCP 81 834 128 0
MSCP 83 756 128 0
MSCP 84 688 128 0
MSCP 84 618 128 0
MSCP 85 546 128 0
MSCP 86 479 128 0
MSCP 141 450 128 0
MSCP 213 450 128 0
MSCP 288 450 128 0
MSCP 361 450 128 0
MSCP 443 450 128 0
MSCP 508 450 128 0
MSCP 582 450 128 0
MSCP 655 450 128 0
MSCP 731 450 128 0
MSCP 796 450 128 0
MSCP 848 460 128 0
MSCP 852 542 128 0
MSCP 848 627 128 0
MSCP 850 712 128 0
MSCP 901 770 128 0
MSCP 995 770 128 0
MSCP 1093 770 128 0
MSCP 1168 750 128 0
MSCP 1265 706 128 0
MSCP 1368 706 128 0
MSCP 1422 792 128 0
MSCP 1424 884 128 0
MSCP 458 186 128 0
MSCP 459 87 128 0
MSCP 541 97 128 0
MSCP 555 181 128 0
MSCP 647 106 128 0
MSCP 679 185 128 0
MSCP 750 113 128 0
MSCP 784 187 128 0
MSCP 862 103 128 0
MSCP 913 179 128 0
MSCP 1015 101 128 0
MSCP 1070 188 128 0
MSCP 1157 106 128 0
MSCP 1228 213 128 0
MSCP 1145 293 128 0
MSCP 1236 383 128 0
MSCP 1347 316 128 0
MSCP 1427 208 128 0
MSCP 1342 146 128 0
MSCP 1535 103 128 0
MSCP 1573 215 128 0
MSCP 1512 351 128 0
MSCP 1685 384 128 0
MSCP 1680 571 128 0
MSCP 1679 688 128 0
MSCP 1679 863 128 0
MSCP 1664 272 128 0
MSCP 1690 109 128 0
MSCP 1800 66 128 0
MSCP 1866 66 128 0
MSCP 1933 148 128 0
MSCP 1933 266 128 0
MSCP 1932 380 128 0
MSCP 1939 492 128 0
MSCP 1935 612 128 0
MSCP 1935 737 128 0
MSCP 1938 876 128 0
BORG 2100 1026 192 0
MSCP 2240 1026 128 0
ZOMBIE 2372 1025 128 0
MSCP 2495 1026 128 0
ZOMBIE 2596 1024 128 0
MSCP 2700 1026 128 0
CLIPPY 1950 2080 128 0
CLIPPY 2288 1429 128 0
CLIPPY 2278 1751 128 0
CLIPPY 2283 2069 128 0
CLIPPY 2614 2070 128 0
CLIPPY 2625 1763 128 0
CLIPPY 2626 1445 128 0
CLIPPY 2985 1436 128 0
CLIPPY 2975 1771 128 0
CLIPPY 2980 2078 128 0
CLIPPY 2978 1165 128 0
CLIPPY 2624 1172 128 0
CLIPPY 2284 1178 128 0
NODOZE 3003 1028 128 0
DEWCAN 1871 2122 128 0
DEWCAN 1913 2122 128 0
ZOMBIE 2511 734 128 0
ZOMBIE 2416 729 128 0
ZOMBIE 2318 733 128 0
ZOMBIE 2216 736 128 0
ZOMBIE 2212 605 128 0
ZOMBIE 2320 610 128 0
ZOMBIE 2410 612 128 0
ZOMBIE 2506 605 128 0
ZOMBIE 2213 481 128 0
ZOMBIE 2317 491 128 0
ZOMBIE 2406 483 128 0
ZOMBIE 2501 487 128 0
ZOMBIE 2215 355 128 0
ZOMBIE 2320 358 128 0
ZOMBIE 2420 358 128 0
ZOMBIE 2510 363 128 0
ZOMBIE 2224 243 128 0
ZOMBIE 2317 245 128 0
ZOMBIE 2424 246 128 0
ZOMBIE 2502 246 128 0
ZOMBIE 2213 125 128 0
ZOMBIE 2313 119 128 0
ZOMBIE 2412 125 128 0
ZOMBIE 2507 124 128 0
MSCP 2641 130 128 0
MSCP 2643 257 128 0
MSCP 2638 387 128 0
MSCP 2639 483 128 0
MSCP 2640 585 128 0
MSCP 2640 711 128 0
MSCP 2642 835 128 0
MSCP 3025 875 128 0
MSCP 3025 770 128 0
MSCP 3026 662 128 0
MSCP 3029 548 128 0
MSCP 3027 449 128 0
MSCP 3035 306 128 0
MSCP 2896 240 128 0
FLAMER 2890 364 128 0
MSCP 2899 506 128 0
MSCP 2894 674 128 0
MSCP 2769 684 128 0
MSCP 2774 522 128 0
MSCP 2775 373 128 0
MSCP 2775 212 128 0
MSCP 2776 96 128 0
MSCP 2878 66 128 0
MSCP 2964 66 128 0
MSCP 3043 66 128 0
MSCP 4460 1718 128 0
MSCP 4554 1513 128 0
MSCP 4623 1718 128 0
MSCP 3314 1705 128 0
MSCP 3217 1507 128 0
MSCP 3149 1704 128 0
MSCP 3632 1650 128 0
MSCP 4146 1663 128 0
MSCP 3872 1662 128 0
MSCP 3645 1790 128 0
MSCP 3875 1784 128 0
MSCP 4149 1797 128 0
MSCP 3626 1532 128 0
MSCP 3871 1541 128 0
MSCP 4146 1549 128 0
MSCP 3753 1657 128 0
MSCP 4033 1668 128 0
MSCP 3746 1540 128 0
MSCP 4027 1551 128 0
MSCP 3749 1769 128 0
MSCP 4035 1780 128 0
TROLL 4236 445 128 0
CLIPPY 4078 462 128 0
CLIPPY 4243 631 128 0
CLIPPY 4415 460 128 0
CLIPPY 4247 300 128 0
CLIPPY 4523 1088 128 0
CLIPPY 4281 1100 128 0
CLIPPY 4096 1102 128 0
CLIPPY 3540 1016 128 0
CLIPPY 3540 798 128 0
CLIPPY 3358 894 128 0
CLIPPY 3728 914 128 0
BUG 6258 1415 128 0
BUG 6093 1412 128 0
BUG 5967 1415 128 0
BUG 5838 1417 128 0
BUG 5701 1411 128 0
BUG 5530 1411 128 0
BUG 5400 1416 128 0
BUG 5383 1309 128 0
