The Sewer
20 16
sewer.table
Dave Lawrence
BASE
|----------|||-----|
|$$$$$$$$$$|||$$$$$|
||||$||$$$$|||$$$$$|
|-||$|||||||||$|||||
|$||$|||||||||$|||||
|$--$---------$|||||
|$$$$$$$$$$$$$$|||||
||||$|||||||||$|||||
||||$|||||||||$|||||
|---$---------$|||||
|$$$$$$$$$$$$$$|||||
|---$---||||||$|||||
|$$$$$$$||||||$|||||
|$|||||$--||||$----|
|$|||||$$$||||$$$$$|
||||||||||||||||||||
OBJECT
-|=+======|---------
-          ---     -
---- --    ---     -
---- ---------.-----
- -- --------- -----
- -- -=+====-- -----
-     .   .    -----
----.--------- -----
---- --------- -----
-==-.--====+=- -----
-     . .     .-----
---- --------- -----
-       ------ -----
- ----- ------ -==--
- -----   ----     -
--------------------
TOPLEVEL
--------------------
-___ __    ---     -
---- --____--- ____-
---- --------- -----
- -- --------- -----
- -- --------- -----
-___ _________ -----
---- --------- -----
---- --------- -----
---- --------- -----
-___ _________ -----
---- --------- -----
- _____ ------ -----
- ----- ------ -----
-_-----___----_____-
--------------------
EVENT
--------------------
- m n   D E---     -
---- -- D  ---     -
-1-- --------- -----
- -- --------- -----
- -- ---------D-----
-   a  DDDDDDDD-----
---- ---------D-----
----A--------- -----
---- --------- -----
-      B       -----
---- --------- -----
-       ------ -----
- ----- -2---- ---4-
- -----   ----     -
--------------------
EVENTMETA
message m y n n y The exit should be only a couple of metres to the east....
message n y n n y D'oh.
message a y n n y I can't get passed, maybe I can turn the gas off somehow.
trigger 1 y y y y <SWITCH> A y 1
trigger 2 y y y y <SWITCH> B y 1
trigger 4 y y y y <SWITCH> D y 1
damage A n y y n KEY=1 <STEAM> 200
damage B n y y n KEY=1 <STEAM> 200
damage D n y y n KEY=1 <STEAM> 200
endlevel E y n n y skyscraper.map
TEXT
1024 862 wheat3 1 <- Gas Main ->
ENTITY
SPAWN 64 60 64 0
ZOMBIE 600 100 64 0

PIZZABOX 1152 58 0 0
BUG 896 64 128 0
BUG 960 64 128 0
BUG 1024 64 128 0
BUG 1088 64 128 0
BUG 1152 64 128 0
BUG 896 128 0 0
BUG 960 128 0 0
BUG 1024 128 0 0
BUG 1088 128 0 0
BUG 1152 128 0 0

BUG 64 768 128 0
BUG 192 768 0 0
BUG 384 768 64 0
BUG 896 768 0 0
BUG 896 832 128 0
BUG 896 896 128 0
