# David Lawrence
Street Spirit
32 55
street.table
Dave Lawrence
BASE
---E```WLLLLLLLLLLLLLLLLLLLLLLLL
SSS}```WLLLLLLLLLLLLLLLLLLLLLLLL
```````WLLLLLLLLLLLLLLLLLLLLLLLL
```````WLLLLLLLLLLLLLLLLLLLLLLLL
```````WLLLLLLLLLLLLLLLLLLLLLLLL
NNN>```WLLLLLLLLLLLLLLLLLLLLLLLL
LLLE```WLLLLLLLLLLLLLLLLLLLLLLLL
LLLE```WjLLLL78889LLLLLLLLLLLLLL
LLLE```W788894555678888888888889
###E```W455561222345555555555556
###E```W12223AAAAA12222222222223
SSS}```{SSSSSSSSSSSSSSSSSSSSSSSS
````````````````````````````````
````````````````````````````````
````````````````````````````````
LLLLLLLLLLLLLL```###############
LLLLLLLLLLLLLL```###############
LLLLLLLLLLLLLL```###############
YYYYYYYXLLLLLL```###############
LLLLLLLXLLLLLL```###############
LLLLLLLXLLLLLL```###############
LLLLLLLLLLLLLL```###############
LLLLLLLLLLLLLL```788888888888889
##############```455555555555556
##############```122222222222223
SSSSSSSSSSSSS}```{SSSSSSSSSSSSSS
````````````````````````````````
````````````````````````````````
````````````````````````````````
NNNNNNNNNNNNN>```<NNNNNNNNNNNNNN
#############E```W#########dHHHH
#############E```W#########ddddd
#############E```W#########ddddd
#############E```W#########ddddd
#############E```W#########dHHHH
#############E```W#########ddddd
#############E```W#########ddddd
#############E```W#########ddddd
LLLLLLLLLLLLLE```WLLLLLLLLLddddd
LLLLLLLLLLLLLE```WLLLLRRRLLddddd
ASSSSSSSSSSSS}```{SSSScccSAddddd
E`````````````````````````Wddddd
E`````````````````````````Wddddd
E`````````````````````````Wddddd
E```W###########################
E```W###########################
E```W###########################
E```W###########################
E```W7888888897888CCC8889#######
E```W45=====564ccccccccc64555556
E```W1222222231222222222312D2223
}```{SSSSSSSSSSSSSSSSSSSSSSSSSSS
````````````````````````````````
````````````````````````````````
````````````````````````````````
````````````````````````````````
OBJECT
SSS     E----------------------W
        E----------------------W
  b     E----------------------W
bm      E----------------------W
        E----------------------W
--W     E----------------------W
--W     E----~~~~~-------------W
--W     ~~~~W-+-+-E~~~~~~~~~~~~~
--W     -+-+--+-+--+-+-+-+-+-+-+
++-     -+-+---D---+-+-+-+-+-+-+
---.....-----i   i--------------
 !          bbbbbbb       !     
             .   .              
             .   .              
             .   .              
-------------W...---------------
-------------W   ---------------
-------------W   ---------------
-------------W   ---------------
-------------W   ---------------
-------X-----W   ---------------
-------------W   ---------------
~~~~~~~~~~~~~W   S+S+S+S+S+S+S+S
--+--+--+--+--   -+-+-+-+-+-+-+-
------D-------...-+-+-+-+-+-+-+-
 !        !          !       !  
                               b
                               b
                               b
                             !  
-------------bbbbb---------.----
-------------     ---------     
-------------     ---------     
-------------     ---------     
-------------     --------- ----
-------------     ---------    r
-------------     ---------  r  
-------------     ---------     
SS+SSSSSSS+SS     SSSSRRRSS     
-------------.....-----y---     
!      !            !           
                              r 
  d                             
                                
     ---------------------------
     ---------------------------
!....---------------------------
     ---------------------------
     SSSSSSSSSSSSSSSSSSSS-------
     --HJ KL---wc-O C-I-sS+SSS+S
     ------g-------D------------
     t!                         
                                
 = = = = = = = = = = = = = = = =
                                
TOPLEVEL
----    ------------------------
        ------------------------
        ------------------------
        ------------------------
~~~     ------------------------
llk     ------------------------
---     ------------------------
---     ----~-----~-------------
---     ------------------------
---     ------------------------
-7-     -----     --------7-----
                                
                 NNNNNNNNNNNNNNN
~~~~~~~~~~~~~~   ###############
lllllllllllllk   ###############
--------------   ---------------
--------------   ---------------
--------------   ---------------
--------------   ---------------
--------------   ---------------
--------------   ---------------
--------------   ---------------
-------------~   -S-S-S-S-S-S-S-
--------------   ---------------
-P--------7---   ----7-------7--
                                
                                
                                
NNNNNNNNNNNNN     NNNNNNNNN  7  
#############     ######### ^^^^
-------------     --------- ----
-------------     ---------     
-------------     ---------     
-------------     --------- ^^^^
-------------     --------- ----
-------------     ---------     
-------------     ---------     
-------------     ---------     
--S-------S--     ----SSS--     
P------P-----     --7------     
                                
                                
     NNNNNNNNNNNNNNNNNNNNNNNNNNN
     ###########################
     ---------------------------
P    ---------------------------
     ---------------------------
     ---------------------------
     ---------------------------
     --[:::]---[:::::::]--S---S-
     -7-------------------------
                                
                                
                                
                                
EVENT
----    ------------------------
        ------------------------
        ------------------------
 E 22222------------------------
   2    ------------------------
---     ------------------------
---     ------------------------
---     ------------------------
---     ------------------------
---     ------------------------
---     -----     --------------
            BBBBBBB             
                                
                                
                                
--------------   ---------------
--------------   ---------------
--------------   ---------------
--------------   ---------------
--------------   ---------------
--------------   ---------------
--------------   ---------------
-------------~   ---------------
--------------   ---------------
--------------   ---------------
                                
                                
                                
                                
                                
-------------     --------- ----
-------------     ---------     
-------------     ---------     
-------------     ---------     
-------------     --------- ----
-------------     ---------     
-------------     ---------     
-------------     ---------     
-------------     ---------     
-------------     ---------     
                                
                                
                                
                                
     ---------------------------
     ---------------------------
     ---------------------------
     ---------------------------
     ---------------------------
     ---------------------------
     ---------------------------
                            1   
                            1   
                            1   
                            1   
EVENTMETA
$map_target 1 y n y y 1 13 9 The skyscraper lies a few blocks North
$map_target B y n y y 0 0 0 Damn, blocked out. I've got to find another way in.
$map_target 2 y n y y 1 1 3 Someone left this manhole open. How convenient.
endlevel E y y n y sewer.map
TEXT
512 3152 yellow 3 Sale Sale Sale
1152 3096 red 3 Appliance world
1400 3148 blue 1 Decent
1410 3164 blue 1 Phone
1160 3148 green 1 Alright
1180 3164 green 1 TV
1260 3148 yellow 1 OK
1270 3164 yellow 1 Computer
ENTITY
SPAWN 1984 3392 192 100
%SPAWN 320 0 128 0
%SPAWN 0 768 64 0
%SPAWN 1984 768 192 0
%SPAWN 0 1728 64 0
%SPAWN 1920 1728 192 0
%SPAWN 1984 2688 224 0

SHOTGUN 1472 2560 0 0
SHELLS 768 1588 0 0

# Top left corner
MSCP 256 64 128 0
MSCP 384 64 128 0
MSCP 256 512 128 0
MSCP 384 512 128 0

#Top horizontal road
ZOMBIE 256 768 64 0
ZOMBIE 896 768 128 0
ZOMBIE 1024 896 0 0

MSCP 960 1088 0 0
MSCP 960 1408 128 0

#2nd Horizontal road

ZOMBIE 64 1664 64 0
MSCP 960 1664 128 0
ZOMBIE 1792 1728 192 0

ZOMBIE 960 2112 128 0
MSCP 1792 2048 192 0

#3rd Horizontal road
MSCP 128 2624 128 0
MSCP 384 2624 192 0
MSCP 1856 2624 192 0

#Bottom horizontal road
MSCP 128 3328 64 0
MSCP 128 3456 64 0
MSCP 896 3328 64 0
ZOMBIE 1152 3456 64 0


