#The map I made especially to test the rabbit AI.
Watership-down
64 32
default.table
Dave Lawrence
OBJECTIVE
type ELIMINATE_CLASS
class NEUTRAL
success_msg "What's up doc" bonus!
nextmap home2.map
BASE
................................................................
................................................................
................................................................
................................................................
................................................................
................................................................
................................................................
................................................................
................................................................
................................................................
................................................................
................................................................
................................................................
................................................................
................................................................
................................................................
................................................................
................................................................
................................................................
................................................................
................................................................
................................................................
................................................................
................................................................
................................................................
................................................................
................................................................
................................................................
................................................................
................................................................
................................................................
................................................................
OBJECT
ffffffffffffffffffffffffffffffffffffffffffffffffffffffffffffffff
-                        fffffffffffffffffffffffffffffffffffffff
-                               ffffffffffffffffffffffffffffffff
-                                        fffffffffffffffffffffff
-   f                                                      f   -
-                                                   f          -
-                                                          f   -
-                                                              -
-                                       f                      -
-                                 f                            -
-             f                                                -
-                                                              -
-                                                              -
-                                                              -
-              f                                               -
-                                                              -
-          f                                           f       -
-                                                              -
-              f f                                             -
-            f                                                 -
-                                                              -
-      f       f    f                                          -
-                                           ff                 -
-                                             f      f         -
-                                                   f  f       -
-                                         f               f    -
-                                                              -
-                                    f      f                  -
-                                   f                          -
-                                      f                       -
-                                                              -
----------------------------------------------------------------
TOPLEVEL
-------------------------FFFFFFFFFFFFFFFFFFFFFFFFFFFFFFFFFFFFFFF
-                        -------FFFFFFFFFFFFFFFFFFFFFFFFFFFFFFFF
-                               ---------FFFFFFFFFFFFFFFFFFFFFFF
-   F                                    ------------------F----
-   -                                               F      -   -
-                                                   -      F   -
-                                                          -   -
-                                       F                      -
-                                 F     -                      -
-             F                   -                            -
-             -                                                -
-                                                              -
-                                                              -
-              F                                               -
-              -                                               -
-          F                                           F       -
-          -                                           -       -
-              F F                                             -
-            F - -                                             -
-            -                                                 -
-      F       F    F                                          -
-      -       -    -                       FF                 -
-                                           --F      F         -
-                                             -     F- F       -
-                                         F         -  -  F    -
-                                         -               -    -
-                                    F      F                  -
-                                   F-      -                  -
-                                   -  F                       -
-                                      -                       -
-                                                              -
----------------------------------------------------------------
EVENT
----------------------------------------------------------------
- 1                      ---------------------------------------
-11                             --------------------------------
-                                        -----------------------
-   -                                                      -   -
-                                                   -          -
-                                                          -   -
-                                                              -
-                                       -                      -
-                                 -                            -
-             -                                                -
-                                                              -
-                                                              -
-                                                              -
-              -                                               -
-                                                              -
-          -                                           -       -
-                                                              -
-              - -                                             -
-            -                                                 -
-                                                              -
-      -       -    -                                          -
-                                           --                 -
-                                             -      -         -
-                                                   -  -       -
-                                         -               -    -
-                                                              -
-                                    -      -                  -
-                                   -                          -
-                                      -                       -
-                                                              -
----------------------------------------------------------------
EVENTMETA
$message 1 y n y y XTux bonus round! Kill all the rabbits to exit the level.
ENTITY
#Max X = 64 * 64 = 4096
#Max Y = 32 * 64 = 2048
SPAWN 64 64 128 200

SMP 128 256 0 0
INVISIBLE 2950 1344 0 0

SHOTGUN 128 60 0 0
SHELLS 192 60 0 0
SHELLS 240 60 0 0
SHELLS 920 60 0 0
CHAINGUN 2496 640 0 0
BULLETS 2560 640 0 0
BULLETS 2624 640 0 0
CHAINGUN 896 1088 0 0
BULLETS 848 1088 0 0
BULLETS 940 1088 0 0
ROCKETS 1472 1240 0 0
BULLETS 1520 240 0 0
SHELLS 1568 1050 0 0
BULLETS 4016 1856 0 0
BAZOOKA 1944 1856 0 0
ROCKETS 2136 1792 0 0
BULLETS 3840 1280 0 0
BULLETS 1472 1600 0 0
BULLETS 3840 1280 0 0
BULLETS 3840 1280 0 0
%CELLS 2264 1240 0 0
%CELLS 2344 1240 0 0
%EGUN 2300 1280 0 0
%CELLS 2264 1320 0 0
%CELLS 2344 1320 0 0
#Holywar only stuff
%SPAWN 2368 128 160 0
%SPAWN 3264 1664 160 0
%SPAWN 2752 1984 160 0

BUNNY 130 157 192 0
BUNNY 400 1101 128 0
BUNNY 520 301 150 0
BUNNY 950 122 190 0
BUNNY 960 170 130 0
BUNNY 1470 690 128 0
BUNNY 380 1525 128 0
BUNNY 2502 520 192 0
BUNNY 1750 434 192 0
BUNNY 2800 570 150 0
BUNNY 2890 280 90 0
BUNNY 960 570 200 0
BUNNY 1250 1880 160 0
BUNNY 1400 1110 118 0
BUNNY 3750 804 162 0
BUNNY 1690 1890 60 0
BUNNY 280 190 20 0
BUNNY 1280 255 180 0
BUNNY 2130 580 12 0
BUNNY 2410 1290 158 0
BUNNY 250 812 200 0
BUNNY 1520 1270 150 0
BUNNY 2960 700 130 0
BUNNY 1450 1360 128 0
BUNNY 1066 570 150 0
BUNNY 930 120 200 0
BUNNY 180 180 128 0
BUNNY 1511 480 192 0
BUNNY 1750 564 192 0
BUNNY 1800 670 150 0
BUNNY 1890 380 90 0
BUNNY 480 280 128 0
BUNNY 2200 280 192 0
BUNNY 2630 1215 128 0
BUNNY 2800 1220 150 0
BUNNY 2890 800 90 0
BUNNY 2930 700 200 0
BUNNY 3400 1100 128 0
BUNNY 750 134 195 0
BUNNY 2520 710 150 0
BUNNY 1960 270 130 0
BUNNY 155 152 128 0
BUNNY 1400 500 128 0
BUNNY 2500 280 192 0
BUNNY 2750 294 192 0
BUNNY 890 130 90 0
BUNNY 570 210 200 0
BUNNY 500 180 192 0
BUNNY 400 1100 128 0
BUNNY 750 900 192 0
BUNNY 3890 450 90 0
BUNNY 4020 1280 128 0
BUNNY 1280 755 128 0
BUNNY 2400 600 158 0
BUNNY 2520 220 150 0
BUNNY 2960 1570 130 0
BUNNY 2400 1100 128 0
BUNNY 1930 380 150 0
BUNNY 930 170 200 0
BUNNY 1200 480 192 0
BUNNY 150 2008 180 0
BUNNY 90 800 90 0
BUNNY 780 280 128 0
BUNNY 2750 920 192 0
BUNNY 1890 806 90 0
BUNNY 130 152 192 0
BUNNY 150 1254 195 0
BUNNY 890 152 90 0
BUNNY 1255 1552 128 0
BUNNY 2580 280 128 0
BUNNY 2460 1890 158 0
BUNNY 2130 570 150 0
BUNNY 2960 570 200 0
BUNNY 3040 1900 128 0
BUNNY 750 460 192 0
BUNNY 550 170 150 0
BUNNY 977 180 90 0
BUNNY 3610 1275 118 0
BUNNY 1280 152 128 0
BUNNY 1400 1240 128 0
BUNNY 2180 505 128 0
BUNNY 30 580 192 0
BUNNY 2900 1700 158 0
BUNNY 2250 234 180 0
BUNNY 290 552 90 0
BUNNY 200 900 192 0
BUNNY 1750 1864 192 0
BUNNY 890 1080 90 0
BUNNY 50 1270 200 0
BUNNY 1820 2000 128 0
BUNNY 1120 480 192 0
BUNNY 1400 200 128 0
BUNNY 1750 700 192 0
BUNNY 3050 670 150 0
BUNNY 990 380 90 0
BUNNY 930 200 200 0
BUNNY 1077 1120 192 0
BUNNY 2750 1240 192 0
BUNNY 1490 1130 90 0
BUNNY 2980 980 90 0
